WE      ./path_to_the_west_texture

NO      ./path_to_the_north_texture

SO ./path_to_the_south_texture
EA                                   ./path_to_the_east_texture   

F                               240                                   ,                153,                    53
C 62,14,122

        11111111111111111111111111
        10000000000110000000000001
        101100000111000001111111111
1111 111100000000000000001
1111111110110000011100001111111
100000000011000011110111111111111
111111111111111111111111111111111
11111 1111111111111111111111111
110011011010011110000010001
100000100000000001100000011111
10000000000000S00110101001000111
11000001110101011111011110000111
11111111111110111011110111101111
111111111111 11111111111111111