WE ./path_to_the_west_texture

NO ./path_to_the_north_texture

SO ./path_to_the_south_texture
EA ./path_to_the_east_texture   

F 240,153,53
C 62,14,122

        1111111111111111111111111
        1000000000110000000000001
        101100000111000001111111111
1111 111100000000000000001
1111111110110000011100001111111
100000000011000001110111111111111
111111111111111111111111111111111
11111 1111111111111111111111111
1100110110100111100000010001
100000100000000001100000011111
10000000000000001101010010001
11000001110101011111011110N0111
11111111111110111011110111101
111111111111 11111111111111111