        WE     ./path_to_the_west_texture 

     NO    ./path_to_the_north_texture 
EA                                   ./path_to_the_east_texture   

SO ./path_to_the_south_texture
C 00062          ,                   14     ,                       0122             
F     31,        00153,                     53


        111111111111111111111111111
     11110000000000110000000000001
 1   1011000001110000011111111111
1111 111100000000000000001
1111111110110000011100001111111
100000000011000011110111111111111
111111111111111111111111111111111
11111 1111111111111111111111111
11001101101001110000010001
100000100000000001100000011111
10000000000000S00110101001000111
1100000111101011111011110000111
11111111111110111011110111101111
111111111111 11111111111111111
