

            WE          ./path_to_the_west_texture
                    F        220   ,       100,   0         

            SO               ./path_to_the_south_texture
            EA     ./path_to_the_east_texture
    C                   225,         0 -> 255  ,              0               
               NO     ./path_to_the_north_texture

       1111111111111111111111111
        1n221n000110000000000001
        121210001110000000000001
        1221000010000000000000001
11111111111111111110000000000001

100000000011000001110111111111111
11110111111111011100000012221
11110111111111011101010012221
11000000111  1011100000012221
10000000000100001100000012221
10000000000000001101010012221
11000001110101011111011112N2111
11110111 1110101 101111012221
11111111 1111111 111111111111







                                    