NO ./textures/eagle.xpm
SO ./textures/greystone.xpm
WE ./textures/bluestone.xpm
EA ./textures/redbrick.xpm

C 135, 206, 235
F 68,68,68


        1111111111111111111111111
        1000000000110000000000001
        1011000001110000000000001
        1001000000000000000000001
111111111011000001110000000000001
100000000011000001110111110111111
11110111111111011100000010001
11110111110111011101010010001
11000000110101011100000010001
10000000000000001100000010001
1000000000N000001101010010001
11000001110101011111011110111
11110111 1110101 101111010001
11111111 1111111 111111111111